NO ./textures/spanch.xpm
SO ./textures/tom.xpm
WE ./textures/skvid.xpm
EA ./textures/arnold.xpm
F 150,180,150
C 186,236,255

111111111111111111111 11111111111
100000000100000000001111111100001
100000000100000000001000000000001
100000000000000000000000000000001
100000000100000000000000000000001
110011111111110000001111100001001
110011111111110000001111100001001
110011111111111110111111100001001
 10000000000000000001000000000101
110000000000000000010011111111001
111111001111110000010010000000001
100000000011110000010010000000001
100000000011110000010011101110001
100000000011110000010011000110001
100000000011110000000011000110001
100010000011110000000011000110001
100010000011110000000011101111111
100010000011110001111000000001111
10001000001111000111110000000111
100010000011110001111100000001111
10000000000000000000W000000001111
100000000000000011100000000001111
11111111111111111 111111111111111
