NO ./textures/mramor.xpm
SO ./textures/kirpich.xpm
WE ./textures/glassfacete.xpm
EA ./textures/derevo.xpm
F 150,180,150
C 186,236,255

111111111111111111111111
100000000000000000000001
100000000000000000000001
100000000000000000000001
100000111110000101010001
100000100010000000000001
10000010N010000100010001
100000100010000000000001
100000110110000101010001
100000000000000000000001
100000000000000000000001
100000000000000000000001
100000000000000001310001
100000000000000001310001
100000000000000001310001
100012100000000001310001
111111111000000001310001
110100001000000001310001
110000101000000001310001
110100001000000001310001
110111111000000001310001
110000000000000000000001
111111111000000000000001
111111111111111111111111
