NO ./textures/bricks.xpm
SO ./textures/mossover.xpm
WE ./textures/glassfacete.xpm
EA ./textures/tilledsoil.xpm
F 220,100,0
C 225,30,0

        1111111111111111111111111
        1000000000110000000000001
        1011000001110000000000001
        1001000000000000000000001
111111111011000001110000000000001
100000000011000001111111111111111
11110111111111111100000010001
11110111111111011101010000001
11000000110101011100000010001
100000000000000000000N0010001
10000000000000001101010010001
11000001110101011111011110111
11110111111101011101111000001
11111111111111111111111111111
