NO ./textures/bricks.xpm
SO ./textures/mossover.xpm
WE ./textures/glassfacete.xpm
EA ./textures/tilledsoil.xpm
F 150,180,150
C 186,236,255


1111111111111
1100000000011
1100000000011
1100000000011
1100000000011
1100000000011
110000N000011
1100000000011
1100000000011
1100000000011
1100000000011
1100000000011
1100000000011
1111111111111
