NO ./textures/mramor.xpm
SO ./textures/kirpich.xpm
WE ./textures/glassfacete.xpm
EA ./textures/derevo.xpm
F 150,180,150
C 186,236,255

111111111111111111111111
100000000000000000000001
100000000000000002000001
100000000000000000000001
100000111110000101010001
100000100010000000000001
10000010N010000100010001
100000100010000000000001
100000110110000101010001
100000000000000000000001
100000000000000000000001
100000000000000000000001
100000002000000002000001
100000000000000000000001
100000000000000000000001
100000000000000000020001
111111111000000000000001
110100001000000000000001
110000101000002000000001
110100001000000000000001
110111111000000020000001
110000000000000000000001
111111111000000000000001
111111111111111111111111
