NO ./textures/mramor.xpm
SO ./textures/kirpich.xpm
WE ./textures/glassfacete.xpm
EA ./textures/derevo.xpm
F 150,180,150
C 186,236,255

111111111111111111111111
100200000000000000000001
100000000000000002000001
100000000000000000000001
100000111110000131310001
100000100010000300030001
10000010N010000100010001
100000100010000300030001
100000113110000131310001
100000000000000000000001
100000000000000000000021
100000000000000000000001
100000002000000002000001
120000000002000000020001
100000000000002000000001
100002002000000000022001
111111111002000020000001
110102001000000000000001
110300101000002000020001
110100001000000000000001
110111111200002020002001
110000003000000000200001
111111111200000000000001
111111111111111111111111
